1 1 1 1 1 1 1 1 1 1 0 0 1 1 1 1 1 1 1 1 1 1 
1 1 1 1 1 1 1 1 1 1 1 1 1 1 1 1 1 1 1 1 1 1 
1 1 1 1 1 1 1 1 1 1 1 1 1 1 1 1 1 1 1 1 1 1 
1 1 1 1 1 1 1 1 1 1 1 1 1 1 1 1 1 1 1 1 1 1 
1 1 1 1 1 1 1 1 1 1 1 1 1 1 1 1 1 1 1 1 1 1 
1 1 1 1 1 1 1 1 1 1 1 1 1 1 1 1 1 1 1 1 1 1 
1 1 1 1 1 1 1 1 1 1 1 1 1 1 1 1 1 1 1 1 1 1 
1 1 1 1 1 1 1 1 1 1 1 1 1 1 1 1 1 1 1 1 1 1 
1 1 1 1 1 1 1 1 1 1 1 1 1 1 1 1 1 1 1 1 1 1 
1 1 1 1 1 1 1 1 1 1 1 1 1 1 1 1 1 1 1 1 1 1 
1 1 1 1 1 1 1 1 1 1 1 1 1 1 1 1 1 1 1 1 1 1 
1 1 1 1 1 1 1 1 1 1 1 1 1 1 1 1 1 1 1 1 1 1 
1 1 1 1 1 1 1 1 1 1 1 1 1 1 1 1 1 1 1 1 1 1 
1 1 1 1 1 1 1 1 1 1 1 1 1 1 1 1 1 1 1 1 1 1 

6 4 4 4 4 4 4 4 4 4 4 4 4 4 4 4 4 4 4 4 4 7 
5 0 0 0 0 0 0 0 0 0 5 0 0 0 0 0 0 0 0 0 0 5 
5 0 0 0 0 0 0 0 0 0 5 0 0 0 0 0 0 0 0 0 0 5 
5 0 0 0 0 0 0 0 0 0 5 0 0 0 0 0 0 0 0 0 0 5 
5 0 0 0 0 0 0 0 0 0 5 0 0 0 0 0 0 0 0 0 0 5 
5 0 0 0 0 0 0 0 0 0 10 0 0 0 0 0 0 0 0 0 0 5 
5 0 0 0 0 0 11 0 0 0 0 0 0 0 0 0 0 0 0 0 0 5 
5 0 0 0 0 0 5 0 0 0 0 0 0 0 6 4 13 0 0 0 0 5 
5 0 0 0 0 0 5 0 0 0 0 0 0 0 5 0 0 0 0 0 0 10 
5 0 0 0 0 0 8 4 4 4 4 0 0 0 5 0 0 0 0 0 0 0 
5 0 0 0 0 0 0 0 0 0 0 0 0 0 5 0 0 0 0 0 0 0 
5 0 0 0 0 0 0 0 0 0 0 0 0 0 5 0 0 0 0 0 0 11 
5 0 0 0 0 0 0 0 0 0 0 0 0 0 5 0 0 0 0 0 0 5 
8 4 4 13 0 0 12 4 4 4 4 4 4 4 4 4 4 4 4 4 4 9 

0 0 0 0 0 0 0 0 0 0 0 0 0 0 0 0 0 0 0 0 0 0 
0 0 0 0 0 0 0 0 0 0 0 0 0 0 0 0 0 0 0 0 0 0 
0 0 0 0 0 0 0 0 0 0 0 0 1 0 0 0 0 0 0 0 0 0 
0 0 0 2 0 0 0 3 0 0 0 0 0 0 0 0 0 0 3 0 0 0 
0 0 0 0 0 0 0 0 0 0 0 0 0 0 0 0 0 0 0 0 0 0 
0 0 0 0 0 0 0 0 0 0 0 0 0 0 0 0 0 0 0 0 0 0 
0 0 0 0 0 0 0 0 2 0 0 0 0 0 0 0 0 0 0 0 0 0 
0 0 0 0 0 0 0 0 0 0 0 0 0 0 0 0 0 0 0 0 0 0 
0 0 0 0 0 0 0 0 0 0 0 0 0 0 0 0 0 0 0 0 0 0 
0 0 0 0 0 0 0 0 0 0 0 0 0 0 0 0 0 0 0 0 0 0 
0 0 0 0 0 0 0 0 0 0 0 0 0 0 0 0 0 0 0 0 0 0 
0 0 0 0 0 0 0 0 0 0 0 0 1 0 0 0 0 2 0 0 0 0 
0 0 0 0 0 0 0 0 0 0 0 0 0 0 0 0 0 0 0 0 0 0 
0 0 0 0 0 0 0 0 0 0 0 0 0 0 0 0 0 0 0 0 0 0 

4
3 352 936 12 384 174
3 416 936 12 384 174
3 1440 680 14 166 712
3 1440 744 14 166 712
