0 0 0 0 0 0 0 1 1 1 0 0 1 1 1 0 0 0 0 0 0 0 
0 0 0 0 0 0 1 1 1 1 1 1 1 1 1 1 0 0 0 0 0 0 
0 0 0 0 0 0 1 1 1 1 2 2 1 1 1 1 0 0 0 0 0 0 
0 0 0 0 0 1 1 1 1 1 2 2 1 1 1 1 0 0 0 0 0 0 
0 0 0 0 0 1 1 1 1 2 2 2 2 1 1 1 0 0 0 0 0 0 
0 0 0 0 0 1 1 1 1 2 2 2 2 1 1 1 0 0 0 0 0 0 
0 0 0 0 0 1 1 1 1 2 2 2 2 1 1 1 0 0 0 0 0 0 
0 0 0 0 0 1 1 1 1 2 2 2 2 1 1 1 0 0 0 0 0 0 
0 0 0 0 0 1 1 1 1 2 2 2 2 1 1 1 0 0 0 0 0 0 
0 0 0 0 0 1 1 1 1 2 2 2 2 1 1 1 0 0 0 0 0 0 
0 0 0 0 0 1 1 1 1 1 2 2 1 1 1 1 0 0 0 0 0 0 
0 0 0 0 0 1 1 1 1 1 2 2 1 1 1 1 1 0 0 0 0 0 
0 0 0 0 0 1 1 1 1 1 1 1 1 1 1 1 1 0 0 0 0 0 
0 0 0 0 0 1 1 1 1 1 1 1 1 1 1 1 1 0 0 0 0 0 

0 0 0 0 0 0 0 6 4 13 0 0 12 4 7 0 0 0 0 0 0 0 
0 0 0 0 0 0 6 9 0 0 0 0 0 0 8 7 0 0 0 0 0 0 
0 0 0 0 0 0 5 0 0 0 0 0 0 0 0 5 0 0 0 0 0 0 
0 0 0 0 0 6 9 0 0 0 0 0 0 0 0 8 7 0 0 0 0 0 
0 0 0 0 0 5 0 0 0 0 0 0 0 0 0 0 5 0 0 0 0 0 
0 0 0 0 0 5 0 0 0 0 0 0 0 0 0 0 5 0 0 0 0 0 
0 0 0 0 0 5 0 0 0 0 0 0 0 0 0 0 5 0 0 0 0 0 
0 0 0 0 0 5 0 0 0 0 0 0 0 0 0 0 5 0 0 0 0 0 
0 0 0 0 0 5 0 0 0 0 0 0 0 0 0 0 5 0 0 0 0 0 
0 0 0 0 0 5 0 0 0 0 0 0 0 0 0 0 5 0 0 0 0 0 
0 0 0 0 0 5 0 0 0 0 0 0 0 0 0 0 5 0 0 0 0 0 
0 0 0 0 0 5 0 0 0 0 0 0 0 0 0 0 5 0 0 0 0 0 
0 0 0 0 0 5 0 0 0 0 0 0 0 0 0 0 5 0 0 0 0 0 
0 0 0 0 0 8 4 4 4 13 0 0 12 4 4 4 5 0 0 0 0 0 

0 0 0 0 0 0 0 0 0 0 0 0 0 0 0 0 0 0 0 0 0 0 
0 0 0 0 0 0 0 0 0 0 0 0 0 0 0 0 0 0 0 0 0 0 
0 0 0 0 0 0 0 0 0 0 0 0 0 0 0 0 0 0 0 0 0 0 
0 0 0 0 0 0 0 0 0 0 0 0 0 0 0 0 0 0 0 0 0 0 
0 0 0 0 0 0 0 0 0 0 0 0 0 0 0 0 0 0 0 0 0 0 
0 0 0 0 0 0 0 0 0 0 0 0 0 0 0 0 0 0 0 0 0 0 
0 0 0 0 0 0 0 0 0 0 0 0 0 0 0 0 0 0 0 0 0 0 
0 0 0 0 0 0 0 0 0 0 0 0 0 0 0 0 0 0 0 0 0 0 
0 0 0 0 0 0 0 0 0 0 0 0 0 0 0 0 0 0 0 0 0 0 
0 0 0 0 0 0 0 0 0 0 0 0 0 0 0 0 0 0 0 0 0 0 
0 0 0 0 0 0 0 0 0 0 0 0 0 0 0 0 0 0 0 0 0 0 
0 0 0 0 0 0 0 0 0 0 0 0 0 0 0 0 0 0 0 0 0 0 
0 0 0 0 0 0 0 0 0 0 0 0 0 0 0 0 0 0 0 0 0 0 
0 0 0 0 0 0 0 0 0 0 0 0 0 0 0 0 0 0 0 0 0 0 

4
3 736 936 14 768 174
3 800 936 14 768 174
3 736 104 16 768 866
3 800 104 16 768 866
