1 0 0 0 0 0 1 1 1 1 0 0 1 1 1 1 1 1 1 1 1 1 
1 1 2 1 1 1 2 1 1 1 2 1 1 1 1 1 2 1 1 1 1 1 
1 2 2 1 1 1 2 1 1 1 2 1 1 1 1 2 2 1 1 1 2 1 
1 2 1 1 1 2 2 1 1 1 2 1 1 1 1 2 1 1 1 1 2 1 
1 1 1 1 1 2 1 1 1 2 2 1 1 1 2 2 1 1 1 2 2 1 
1 1 1 1 2 2 1 1 1 2 1 1 1 1 2 1 1 1 1 2 1 1 
1 1 1 1 2 1 1 1 1 2 1 1 1 1 2 1 1 1 1 2 1 1 
1 1 1 2 2 1 1 1 2 2 1 1 1 2 2 1 1 1 2 2 1 1 
1 1 1 2 1 1 1 1 2 1 1 1 1 2 1 1 1 1 2 1 1 1 
1 1 2 2 1 1 1 2 2 1 1 1 2 2 1 1 1 1 2 1 1 1 
1 1 2 1 1 1 1 2 1 1 1 1 2 1 1 1 1 2 2 1 1 1 
1 2 2 1 1 1 2 2 1 1 1 2 2 1 1 1 1 2 1 1 1 1 
1 2 1 1 1 1 2 1 1 1 1 2 1 1 1 1 1 2 1 1 1 1 
1 1 1 1 1 1 1 1 1 1 1 1 1 1 1 1 1 1 1 1 1 1 

6 4 4 4 4 4 4 4 4 4 4 4 4 4 4 4 4 4 4 4 4 7 
5 0 0 0 0 0 0 0 0 0 0 0 0 0 0 0 0 0 0 0 0 5 
5 0 0 0 0 0 0 0 0 0 0 0 0 0 0 0 0 0 0 0 0 5 
5 0 0 0 0 0 0 0 0 0 0 0 0 0 0 0 0 0 0 0 0 5 
5 0 0 0 0 0 0 0 0 0 0 0 0 0 0 0 0 0 0 0 0 5 
5 0 0 0 0 0 0 0 0 0 0 0 0 0 0 0 0 0 0 0 0 5 
5 0 0 0 0 0 0 0 0 0 0 0 0 0 0 0 0 0 0 0 0 5 
5 0 0 0 0 0 0 0 0 0 0 0 0 0 0 0 0 0 0 0 0 5 
5 0 0 0 0 0 0 0 0 0 0 0 0 0 0 0 0 0 0 0 0 5 
5 0 0 0 0 0 0 0 0 0 0 0 0 0 0 0 0 0 0 0 0 5 
5 0 0 0 0 0 0 0 0 0 0 0 0 0 0 0 0 0 0 0 0 5 
5 0 0 0 0 0 0 0 0 0 0 0 0 0 0 0 0 0 0 0 0 5 
5 0 0 0 0 0 0 0 0 0 0 0 0 0 0 0 0 0 0 0 0 5 
8 4 4 4 4 4 4 4 4 4 4 4 4 4 4 4 4 4 4 4 4 9 

0 0 0 0 0 0 0 0 0 0 0 0 0 0 0 0 0 0 0 0 0 0 
0 0 0 0 0 0 0 0 0 0 0 0 0 0 0 0 0 0 0 0 0 0 
0 0 0 0 0 0 0 0 0 0 0 0 0 0 0 0 0 0 0 0 0 0 
0 0 0 0 0 0 0 0 0 0 0 0 0 0 0 0 0 0 0 0 0 0 
0 0 0 0 0 0 0 0 0 0 0 0 0 0 0 0 0 0 0 0 0 0 
0 0 0 0 0 0 0 0 0 0 0 0 0 0 0 0 0 0 0 0 0 0 
0 0 0 0 0 0 0 0 0 0 0 0 0 0 0 0 0 0 0 0 0 0 
0 0 0 0 0 0 0 0 0 0 0 0 0 0 0 0 0 0 0 0 0 0 
0 0 0 0 0 0 0 0 0 0 0 0 0 0 0 0 0 0 0 0 0 0 
0 0 0 0 0 0 0 0 0 0 0 0 0 0 0 0 0 0 0 0 0 0 
0 0 0 0 0 0 0 0 0 0 0 0 0 0 0 0 0 0 0 0 0 0 
0 0 0 0 0 0 0 0 0 0 0 0 0 0 0 0 0 0 0 0 0 0 
0 0 0 0 0 0 0 0 0 0 0 0 0 0 0 0 0 0 0 0 0 0 
0 0 0 0 0 0 0 0 0 0 0 0 0 0 0 0 0 0 0 0 0 0 

0
