0 0 0 0 0 0 0 0 0 0 0 0 0 0 0 0 0 0 0 0 0 0 
0 0 0 0 0 1 1 1 1 1 1 2 2 1 1 1 1 1 1 0 0 0 
0 0 0 1 2 1 1 1 2 1 1 1 2 1 1 1 1 2 1 1 0 0 
0 1 1 2 1 1 1 1 1 1 1 1 1 1 1 1 1 2 1 1 1 0 
1 1 2 2 2 1 1 1 1 2 2 2 1 1 1 1 1 1 1 2 1 1 
1 1 1 1 1 1 1 1 2 2 2 2 2 2 1 1 1 1 1 2 1 1 
1 1 2 1 1 1 1 1 2 2 2 2 2 1 1 1 1 1 1 1 1 1 
1 1 1 2 2 1 1 1 1 2 2 2 2 1 1 1 1 2 1 1 1 1 
1 1 1 1 1 1 1 1 1 1 1 1 1 1 1 1 1 1 1 1 1 1 
1 1 1 1 1 1 1 1 1 1 1 1 1 1 1 1 1 1 1 1 1 1 
1 1 1 1 1 1 1 2 1 1 1 1 1 1 1 1 1 1 1 1 2 1 
1 1 1 1 1 1 1 1 1 1 1 1 1 1 1 1 1 2 2 2 1 1 
1 1 1 2 2 1 1 1 1 1 1 1 1 1 1 1 1 2 1 1 1 1 
1 1 1 1 1 1 1 1 1 1 1 1 1 1 1 1 1 1 1 1 1 1 

0 0 0 0 6 4 4 4 4 4 4 4 4 4 4 4 4 7 0 0 0 0 
0 0 0 6 9 0 0 0 0 0 0 0 0 0 0 0 0 8 7 0 0 0 
0 0 6 9 0 0 0 0 0 0 0 0 0 0 0 0 0 0 8 7 0 0 
0 6 9 0 0 0 0 0 0 0 0 0 0 0 0 0 0 0 0 8 7 0 
6 9 0 0 0 0 0 0 0 0 0 0 0 0 0 0 0 0 0 0 8 7 
5 0 0 0 0 0 0 0 0 0 0 0 0 0 0 0 0 0 0 0 0 5 
5 0 0 0 0 0 0 0 0 0 0 0 0 0 0 0 0 0 0 0 0 5 
5 0 0 0 0 0 0 0 0 0 0 0 0 0 0 0 0 0 0 0 0 5 
5 0 0 0 0 0 0 0 0 0 0 0 0 0 0 0 0 0 0 0 0 5 
5 0 0 0 0 0 0 0 0 0 0 0 0 0 0 0 0 0 0 0 0 5 
5 0 0 0 0 0 0 0 0 0 0 0 0 0 0 0 0 0 0 0 0 5 
5 0 0 0 0 0 0 0 0 0 0 0 0 0 0 0 0 0 0 0 0 5 
5 0 0 0 0 0 0 0 0 0 0 0 0 0 0 0 0 0 0 0 0 5 
8 4 4 4 4 4 4 4 4 13 0 0 12 4 4 4 4 4 4 4 4 9 

0 0 0 0 0 0 0 0 0 0 0 0 0 0 0 0 0 0 0 0 0 0 
0 0 0 0 0 0 0 0 0 0 0 0 0 0 0 0 0 0 0 0 0 0 
0 0 0 0 0 0 0 0 1 0 0 0 0 0 0 0 0 0 0 0 0 0 
0 0 0 0 0 0 0 0 0 0 0 0 0 0 0 0 0 0 0 0 0 0 
0 0 0 0 0 0 0 0 0 0 0 0 0 0 0 2 0 0 0 0 0 0 
0 0 0 0 0 0 0 0 0 0 0 0 0 0 0 0 0 0 0 0 0 0 
0 0 1 0 0 0 0 0 0 0 0 0 1 0 0 0 0 0 0 0 0 0 
0 0 0 0 0 0 0 0 0 0 0 0 0 0 0 0 0 0 0 0 0 0 
0 0 0 0 0 0 0 0 0 0 0 0 0 0 0 0 0 0 0 0 0 0 
0 0 0 0 0 0 2 0 0 0 0 0 0 0 0 0 0 0 0 0 0 0 
0 0 0 0 0 0 0 0 0 0 0 0 0 0 0 0 0 2 0 0 0 0 
0 0 0 0 0 0 0 0 0 0 0 0 0 0 0 0 0 0 0 0 0 0 
0 0 0 0 0 0 0 0 0 0 0 0 0 0 0 0 0 0 0 0 0 0 
0 0 0 0 0 0 0 0 0 0 0 0 0 0 0 0 0 0 0 0 0 0 

2
3 736 936 6 768 174
3 800 936 6 768 174
