1 1 1 1 1 1 1 1 1 1 0 0 1 1 1 1 1 1 1 1 1 1 
1 1 1 1 1 1 1 1 1 1 1 1 1 1 1 1 1 1 1 1 1 1 
1 1 1 1 1 1 1 1 1 1 1 1 1 1 1 1 1 1 1 1 1 1 
1 1 1 1 2 2 1 1 1 1 1 1 1 1 1 1 2 2 1 1 1 1 
1 1 1 1 2 2 1 1 1 1 1 1 1 1 1 1 2 2 1 1 1 1 
1 1 1 1 2 2 1 1 1 1 1 1 1 1 1 1 2 2 1 1 1 1 
1 1 1 1 2 2 1 1 1 1 1 1 1 1 1 1 2 2 1 1 1 1 
1 1 1 1 2 2 1 1 1 1 1 1 1 1 1 1 2 2 1 1 1 1 
1 1 1 1 2 2 1 1 1 1 1 1 1 1 1 1 2 2 1 1 1 1 
1 1 1 1 2 2 1 1 1 1 1 1 1 1 1 1 2 2 1 1 1 1 
1 1 1 1 2 2 1 1 1 1 1 1 1 1 1 1 2 2 1 1 1 1 
1 1 1 1 1 1 1 1 1 1 1 1 1 1 1 1 1 1 1 1 1 1 
1 1 1 1 1 1 1 1 1 1 1 1 1 1 1 1 1 1 1 1 1 1 
1 1 1 1 1 1 1 1 1 1 1 1 1 1 1 1 1 1 1 1 1 1 

6 4 4 4 4 4 4 4 4 4 4 4 4 4 4 4 4 4 4 4 4 7 
5 0 0 0 0 0 0 0 0 0 0 0 0 0 0 0 0 0 0 0 0 5 
5 0 0 0 0 0 0 0 0 0 0 0 0 0 0 0 0 0 0 0 0 5 
5 0 0 0 0 0 0 0 0 0 0 12 4 7 0 0 0 0 0 0 0 5 
5 0 0 0 0 0 0 0 0 0 0 0 0 8 7 0 0 0 0 0 0 5 
5 0 0 0 0 0 0 0 0 0 0 0 0 0 5 0 0 0 0 0 0 10 
5 0 0 0 0 0 0 0 0 0 0 0 0 0 10 0 0 0 0 0 0 0 
5 0 0 0 0 0 0 11 0 0 0 0 0 0 0 0 0 0 0 0 0 0 
5 0 0 0 0 0 0 5 0 0 0 0 0 0 0 0 0 0 0 0 0 11 
5 0 0 0 0 0 0 8 7 0 0 0 0 0 0 0 0 0 0 0 0 5 
5 0 0 0 0 0 0 0 8 4 13 0 0 0 0 0 0 0 0 0 0 5 
5 0 0 0 0 0 0 0 0 0 0 0 0 0 0 0 0 0 0 0 0 5 
5 0 0 0 0 0 0 0 0 0 0 0 0 0 0 0 0 0 0 0 0 5 
8 4 4 4 4 4 4 4 4 4 4 4 4 4 4 4 4 4 4 4 4 9 

0 0 0 0 0 0 0 0 0 0 0 0 0 0 0 0 0 0 0 0 0 0 
0 0 0 0 0 0 0 0 0 0 0 0 0 0 0 0 0 0 0 0 0 0 
0 0 0 0 0 0 0 0 0 0 0 0 0 0 0 1 0 0 0 0 0 0 
0 0 0 0 0 1 0 0 0 0 0 0 0 0 0 0 0 0 0 0 0 0 
0 0 0 0 0 0 0 0 0 0 0 0 0 0 0 0 0 0 0 0 0 0 
0 0 0 0 0 0 0 0 0 0 0 0 0 0 0 0 0 0 0 0 0 0 
0 0 0 0 0 0 0 0 0 0 0 0 0 0 0 0 0 0 0 0 0 0 
0 0 0 0 0 0 0 0 0 0 0 0 0 0 0 0 0 0 0 0 0 0 
0 0 0 0 0 0 0 0 0 0 0 0 0 0 0 0 0 0 0 0 0 0 
0 0 0 0 0 0 0 0 0 0 0 0 0 0 0 0 0 0 0 0 0 0 
0 0 0 0 0 0 0 0 0 0 0 0 0 0 0 0 0 0 0 0 0 0 
0 0 1 0 0 0 0 0 0 0 0 0 0 0 0 0 0 0 0 0 0 0 
0 0 0 0 0 0 0 0 0 0 0 0 0 0 0 0 0 0 0 0 0 0 
0 0 0 0 0 0 0 0 0 0 0 0 0 0 0 0 0 0 0 0 0 0 

2
3 1440 488 1 166 520
3 1440 552 1 166 520
